UBBBBBBBBBBBBBBBBBBBBBBBBBBBBBBBBBBB9BBBBBBBBBBBBBBBBBBBBBBBBBBBBBBBBBBBBBBBBBBBBBBBBBBBBBBBBBBBBBBB9BBBBBBBBBBBBBBBBBBBBBBBBBBBBBBBBBBBBBBBBBBBBBBBBBBBBBBBBBBBBBBBBBBBBBBBBBBBBBBBBBBBBBBBBBBBBBBBBBBBBBM
A x                    A                           A                                                A                                                    A                          A                    xA
A   x                  A                           A  __      ____  _  _  ____  ____  ____  ____    A     ___  _____  ____  ____  ____  ____        __   A                          A                  x  A
A     x                A                           A / / ___ ( ___)( \( )(_  _)(  _ \( ___)( ___)   A    / __)(  _  )(  _ \(_  _)(_  _)( ___)   ___ \ \  A                          A                x    A
A       x              A                           A< < (___) )__)  )  (   )(   )   / )__)  )__)    A    \__ \ )(_)(  )   /  )(   _)(_  )__)   (___) > > A                          A              x      A
A         x            A                           A \_\     (____)(_)\_) (__) (_)\_)(____)(____)   A    (___/(_____)(_)\_) (__) (____)(____)       /_/  A                          A            x        A
A           x          A                           A                                                A                                                    A                          A          x          A
A            UBBBBBBBBBL                           KBBBBBBBBBBBBBBBBBBBBBBBBBBBBBBBBBBBBBBBBBBBBBBBBRBBBBBBBBBBBBBBBBBBBBBBBBBBBBBBBBBBBBBBBBBBBBBBBBBBBBL                          KBBBBBBBBBM           A
A            GB9BBBBBBBB                                                                                                                                                            BBBBBBBB9B3           A
A            AsA                                                                                                                                                                              A           A
A            AsA                                                                                                                                                                              A           A
A            AsA                                                                                                                                                                              A           A
A            AsA                                                                                                                                                                              A           A
A            AsA                                                                                                                                                                              A           A
A            GB9BBBBBBBB                                         BBBBBBBBB9B9B9BBBBBBBBB                           BBBBBBBBB9B9B9BBBBBBBBB                                          BBBBBBBB9B3           A
A            AsA                                                          AsAsA                                             AsAsA                                                           AsA           A
A            AsA                                                          AsAsA                                             AsAsA                                                           AsA           A
A            AsA                                                          AsAsA                                             AsAsA                                                           AsA           A
A            AsA                                                          AsAsA                                             AsAsA                                                           AsA           A
A            AsA                                                          AsAsA                                             AsAsA                                                           AsA           A
A            GB6BBBBBBBB                                         BBBBBBBBB6B6B6BBBBBBBBB                           BBBBBBBBB6B6B6BBBBBBBBB                                          BBBBBBBB6B3           A
A            AsA                                                          AsAsA                                             AsAsA                                                           AsA           A
A            AsA                                                          AsAsA                                             AsAsA                                                           AsA           A
A            AsA                                                          AsAsA                                             AsAsA                                                           AsA           A
A            AsA                                                          AsAsA                                             AsAsA                                                           AsA           A
A            AsA                                                          AsAsA                                             AsAsA                                                           AsA           A
A            GB6BBBBBBBB                                         BBBBBBBBB6B6B6BBBBBBBBB                           BBBBBBBBB6B6B6BBBBBBBBB                                          BBBBBBBB6B3           A
A            AsA                                                          AsAsA                                             AsAsA                                                           AsA           A
A            AsA                                                          AsAsA                                             AsAsA                                                           AsA           A
A            AsA                                                          AsAsA                                             AsAsA                                                           AsA           A
A            AsA                                                          AsAsA                                             AsAsA                                                           AsA           A
A            AsA                                                          AsAsA                                             AsAsA                                                           AsA           A
A            GB6BBBBBBBB                                         BBBBBBBBB6B6B6BBBBBBBBB                           BBBBBBBBB6B6B6BBBBBBBBB                                          BBBBBBBB6B3           A
A            AsA                                                          AsAsA                                             AsAsA                                                           AsA           A
A            AsA                                                          AsAsA                                             AsAsA                                                           AsA           A
A            AsA                                                          AsAsA                                             AsAsA                                                           AsA           A
A            AsA                                                          AsAsA                                             AsAsA                                                           AsA           A
A            AsA                                                          AsAsA                                             AsAsA                                                           AsA           A
A            3B6BBBBBBBB                                         BBBBBBBBB6B6B6BBBBBBBBB                           BBBBBBBBB6B6B6BBBBBBBBB                                          BBBBBBBB6B3           A
A            AsA                                                          AsAsA                                             AsAsA                                                           AsA           A
A            AsA                                                          AsAsA                                             AsAsA                                                           AsA           A
A            AsA                                                          AsAsA                                             AsAsA                                                           AsA           A
A            AsA                                                          AsASA                                             AsAsA                                                           AsA           A
A            AsA                                                          AsAsA                                             AsAsA                                                           AsA           A
A            3B6BBBBBBBB                                         BBBBBBBBB6B6B6BBBBBBBBB                           BBBBBBBBBRBRBRBBBBBBBBB                                          BBBBBBBB6B3           A
A            AsA                                                                                                                                                                            AsA           A    
A            AsA                                                                                                                                                                            AsA           A
A            AsA                                                                                                                                                                            AsA           A
A            AsA                                                                                                                                                                            AsA           A  
A            AsA                                                                                                                                                                            AsA           A
A            ABRBBBBBBBB                                                                                                                                                            BBBBBBBBRB3           A
A            KBBBBBBBBBBBBBBBBBBBBBBBBBBBBBBBBBBBBBBBBBBBBBBBBBBBBBBBBBBBBBBBBBBBBBBBBBBBBBBBBBBBBBBBBBBBBBBBBBBBBBBBBBBBBBBBBBBBBBBBBBBBBBBBBBBBBBBBBBBBBBBBBBBBBBBBBBBBBBBBBBBBBBBBBBBBBBBBBL           A
A          x                                                                                                                                                                                   x          A
A        x                                                                                                                                                                                       x        A
A      x                                                                                                                                                                                           x      A
A    x                                                                                                                                                                                               x    A
A  x                                                                                                                                                                                                   x  A
Ax                                                                                                                                                                                                       xA
KBBBBBBBBBBBBBBBBBBBBBBBBBBBBBBBBBBBBBBBBBBBBBBBBBBBBBBBBBBBBBBBBBBBBBBBBBBBBBBBBBBBBBBBBBBBBBBBBBBBBBBBBBBBBBBBBBBBBBBBBBBBBBBBBBBBBBBBBBBBBBBBBBBBBBBBBBBBBBBBBBBBBBBBBBBBBBBBBBBBBBBBBBBBBBBBBBBBBBBBBBL
