UBBBBBBBBBBBBBBBBBBBBBBBBBBBBBBBBBBBBBBBBBBBBBBBBBBBBBBBBBBBBBBBBBBBBBBBBBBBBBBBBBBBBBBBBBBBBBBBBBBBBBBBBBBBBBBBBBBBBBBBBBBBBBBBBBBBBBBBBBBBBBBBBBBBBBBBBBBBBBBBBBBBBBBBBBBBBBBBBBBBBBBBBBBBBBBBBBBBBBBBBBM
A x                                                                                                                                                                                                      xA
A   x                                                                                                                                                                                                  x  A
A     x          UBBBBBBBBBBBBBBBBBBM                                                                                                                                   UBBBBBBBBBBBBBBBBBBM         x    A
A       x        A                  A                                                                                                                                   A                  A       x      A
A         x      A   ù              A                                                                                                                                   A   ¨              A     x        A
A           x    A                  A                                                                                                                                   A                  A   x          A
A            UBBBRBBBBBBBBBBBBBBBBBBRBBBBBBBBBBBBBBBBBBBBBBBBBBBBBBBBBBBBBBBBBBBBBBBBBBBBBBBBBBBBBBBBBBBBBBBBBBBBBBBBBBBBBBBBBBBBBBBBBBBBBBBBBBBBBBBBBBBBBBBBBBBBBBBBBBBRBBBBBBBBBBBBBBBBBBRBBM           A
A            A                                                                                                                                                                                A           A
A            A                                                                                                                                                                                A           A
A            A                                                                                                                                                                                A           A
A            GBBBBBBBBBBBBB                                                                                                                                                                   A           A
A            GB9BBBBBBBBBBB                                   BBBBBBBBBBBB9B9B9BBBBBBBBBBBB                     BBBBBBBBBBBB9B9B9BBBBBBBBBBBB                                    BBBBBBBBBBB9B3           A
A            AsA                                                          AsAsA                                             AsAsA                                                           AsA           A
A            AsA                                                          AsAsA                                             AsAsA                                                           AsA           A
A            AsA                                                          AsAsA                                             AsAsA                                                           AsA           A
A            GB6BBBBBBBBBBB                                   BBBBBBBBBBBB6B6B6BBBBBBBBBBBB                     BBBBBBBBBBBB6B6B6BBBBBBBBBBBB                                    BBBBBBBBBBB6B3           A
A            AsA                                                          AsAsA                                             AsAsA                                                           AsA           A
A            AsA                                                          AsAsA                                             AsAsA                                                           AsA           A
A            AsA                                                          AsAsA                                             AsAsA                                                           AsA           A
A            GB6BBBBBBBBBBB                                   BBBBBBBBBBBB6B6B6BBBBBBBBBBBB                     BBBBBBBBBBBB6B6B6BBBBBBBBBBBB                                    BBBBBBBBBBB6B3           A
A            AsA                                                          AsAsA                                             AsAsA                                                           AsA           A
A            AsA                                                          AsAsA                                             AsAsA                                                           AsA           A
A            AsA                                                          AsAsA                                             AsAsA                                                           AsA           A
A            GB6BBBBBBBBBBB                                   BBBBBBBBBBBB6B6B6BBBBBBBBBBBB                     BBBBBBBBBBBB6B6B6BBBBBBBBBBBB                                    BBBBBBBBBBB6B3           A
A            AsA                                                          AsAsA                                             AsAsA                                                           AsA           A
A            AsA                                                          AsAsA                                             AsAsA                                                           AsA           A
A            AsA                                                          AsAsA                                             AsAsA                                                           AsA           A
A            GB6BBBBBBBBBBB                                   BBBBBBBBBBBB6B6B6BBBBBBBBBBBB                     BBBBBBBBBBBB6B6B6BBBBBBBBBBBB                                    BBBBBBBBBBB6B3           A
A            AsA                                                          AsAsA                                             AsAsA                                                           AsA           A
A            AsA                                                          AsAsA                                             AsAsA                                                           AsA           A
A            AsA                                                          AsAsA                                             AsAsA                                                           AsA           A
A            AB6BBBBBBBBBBB                                   BBBBBBBBBBBB6B6B6BBBBBBBBBBBB                     BBBBBBBBBBBB6B6B6BBBBBBBBBBBB                                    BBBBBBBBBBB6B3           A
A            AsA                                                          AsAsA                                             AsAsA                                                           AsA           A
A            AsA                                                          AsAsA                                             AsAsA                                                           AsA           A
A            AsA                                                          AsAsA                                             AsAsA                                                           AsA           A
A            3B6BBBBBBBBBBB                                   BBBBBBBBBBBB6B6B6BBBBBBBBBBBB                     BBBBBBBBBBBB6B6B6BBBBBBBBBBBB                                    BBBBBBBBBBB6B3           A
A            AsA                                                          AsAsA                                             AsAsA                                                           AsA           A
A            AsA                                                          AsAsA                                             AsAsA                                                           AsA           A
A            AsA                                                          AsAsA                                             AsAsA                                                           AsA           A
A            AB6BBBBBBBBBBB                                   BBBBBBBBBBBBRBRBRBBBBBBBBBBBB                     BBBBBBBBBBBBRBRBRBBBBBBBBBBBB                                    BBBBBBBBBBB6B3           A
A            AsA                                                                                                                                                                            AsA           A
A            AsA                                                                                                                                                                            AsA           A
A            AsA                                                                                                                                                                            AsA           A
A            ABRBBBBBBBBBBB                                                                                                                                                      BBBBBBBBBBBRB3           A
A            KBBBBBBBBBBBBBBBBBBBBBBBBBBBBBBBBBBBBBBBBBBBBBBBBBBBBBBBBBBBBBBBBBBBBBBBBBBBBBBBBBBBBBBBBBBBBBBBBBBBBBBBBBBBBBBBBBBBBBBBBBBBBBBBBBBBBBBBBBBBBBBBBBBBBBBBBBBBBBBBBBBBBBBBBBBBBBBBBL           A
A          x                                                                                                                                                                                   x          A
A        x                                                                                                                                                                                       x        A
A      x                                                                                                                                                                                           x      A
A    x                                                                                                                                                                                               x    A
A  x                                                                                                                                                                                                   x  A
Ax                                                                                                                                                                                                       xA
KBBBBBBBBBBBBBBBBBBBBBBBBBBBBBBBBBBBBBBBBBBBBBBBBBBBBBBBBBBBBBBBBBBBBBBBBBBBBBBBBBBBBBBBBBBBBBBBBBBBBBBBBBBBBBBBBBBBBBBBBBBBBBBBBBBBBBBBBBBBBBBBBBBBBBBBBBBBBBBBBBBBBBBBBBBBBBBBBBBBBBBBBBBBBBBBBBBBBBBBBBL
