UBBBBBBBBBBBBBBBBBBBBBBBBBBBBBBBBBBBBBBBBBBBBBBBBBBBBBBBBBBBBBBBBBBBBBBBBBBBBBBBBBBBBBBBBBBBBBBBBBBBBBBBBBBBBBBBBBBBBBBBBBBBBBBBBBBBBBBBBBBBBBBBBBBBBBBBBBBBBBBBBBBBBBBBBBBBBBBBBBBBBBBBBBBBBBBBBBBBBBBBBBM
A x                                                                                                                                                                                                      xA
A   x                                                                                                                                                                                                  x  A
A     x          UBBBBBBBBBBBBBBBBBBM                                                                                                                                   UBBBBBBBBBBBBBBBBBBM         x    A
A       x        A                  A                                                                                                                                   A                  A       x      A
A         x      A   ù              A                                                                                                                                   A   ¨              A     x        A
A           x    A                  A                                                                                                                                   A                  A   x          A
A            UBBBRBBBBBBBBBBBBBBBBBBRBBBBBBBBBBBBBBBBBBBBBBBBBBBBBBBBBBBBBBBBBBBBBBBBBBBBBBBBBBBBBBBBBBBBBBBBBBBBBBBBBBBBBBBBBBBBBBBBBBBBBBBBBBBBBBBBBBBBBBBBBBBBBBBBBBBRBBBBBBBBBBBBBBBBBBRBBM           A
A            A00000000000000000000000000000000000000000000000000000000000000000000000000000000000000000000000000000000000000000000000000000000000000000000000000000000000000000000000000000000A           A
A            A00000000000000000000000000000000000000000000000000000000000000000000000000000000000000000000000000000000000000000000000000000000000000000000000000000000000000000000000000000000A           A
A            A00000000000000000000000000000000000000000000000000000000000000000000000000000000000000000000000000000000000000000000000000000000000000000000000000000000000000000000000000000000A           A
A            GBBBBBBBBBBBBB0000000000000000000000000000000000000000000000000000000000000000000000000000000000000000000000000000000000000000000000000000000000000000000000000000000000000000000A           A
A            GB9BBBBBBBBBBB00000000000000000000000000000000000BBBBBBBBBBBB9B9B9BBBBBBBBBBBB000000000000000000000BBBBBBBBBBBB9B9B9BBBBBBBBBBBB000000000000000000000000000000000000BBBBBBBBBBB9B3           A
A            AsA0000000000000000000000000000000000000000000000000000000000AsAsA000000000000000000000000000000000000000000000AsAsA00000000000000000000000000000000000000000000000000000000000AsA           A
A            AsA0000000000000000000000000000000000000000000000000000000000AsAsA000000000000000000000000000000000000000000000AsAsA00000000000000000000000000000000000000000000000000000000000AsA           A
A            AsA0000000000000000000000000000000000000000000000000000000000AsAsA000000000000000000000000000000000000000000000AsAsA00000000000000000000000000000000000000000000000000000000000AsA           A
A            GB6BBBBBBBBBBB00000000000000000000000000000000000BBBBBBBBBBBB6B6B6BBBBBBBBBBBB000000000000000000000BBBBBBBBBBBB6B6B6BBBBBBBBBBBB000000000000000000000000000000000000BBBBBBBBBBB6B3           A
A            AsA0000000000000000000000000000000000000000000000000000000000AsAsA000000000000000000000000000000000000000000000AsAsA00000000000000000000000000000000000000000000000000000000000AsA           A
A            AsA0000000000000000000000000000000000000000000000000000000000AsAsA000000000000000000000000000000000000000000000AsAsA00000000000000000000000000000000000000000000000000000000000AsA           A
A            AsA0000000000000000000000000000000000000000000000000000000000AsAsA000000000000000000000000000000000000000000000AsAsA00000000000000000000000000000000000000000000000000000000000AsA           A
A            GB6BBBBBBBBBBB00000000000000000000000000000000000BBBBBBBBBBBB6B6B6BBBBBBBBBBBB000000000000000000000BBBBBBBBBBBB6B6B6BBBBBBBBBBBB000000000000000000000000000000000000BBBBBBBBBBB6B3           A
A            AsA0000000000000000000000000000000000000000000000000000000000AsAsA000000000000000000000000000000000000000000000AsAsA00000000000000000000000000000000000000000000000000000000000AsA           A
A            AsA0000000000000000000000000000000000000000000000000000000000AsAsA000000000000000000000000000000000000000000000AsAsA00000000000000000000000000000000000000000000000000000000000AsA           A
A            AsA0000000000000000000000000000000000000000000000000000000000AsAsA000000000000000000000000000000000000000000000AsAsA00000000000000000000000000000000000000000000000000000000000AsA           A
A            GB6BBBBBBBBBBB00000000000000000000000000000000000BBBBBBBBBBBB6B6B6BBBBBBBBBBBB000000000000000000000BBBBBBBBBBBB6B6B6BBBBBBBBBBBB000000000000000000000000000000000000BBBBBBBBBBB6B3           A
A            AsA0000000000000000000000000000000000000000000000000000000000AsAsA000000000000000000000000000000000000000000000AsAsA00000000000000000000000000000000000000000000000000000000000AsA           A
A            AsA0000000000000000000000000000000000000000000000000000000000AsAsA000000000000000000000000000000000000000000000AsAsA00000000000000000000000000000000000000000000000000000000000AsA           A
A            AsA0000000000000000000000000000000000000000000000000000000000AsAsA000000000000000000000000000000000000000000000AsAsA00000000000000000000000000000000000000000000000000000000000AsA           A
A            GB6BBBBBBBBBBB00000000000000000000000000000000000BBBBBBBBBBBB6B6B6BBBBBBBBBBBB000000000000000000000BBBBBBBBBBBB6B6B6BBBBBBBBBBBB000000000000000000000000000000000000BBBBBBBBBBB6B3           A
A            AsA0000000000000000000000000000000000000000000000000000000000AsAsA000000000000000000000000000000000000000000000AsAsA00000000000000000000000000000000000000000000000000000000000AsA           A
A            AsA0000000000000000000000000000000000000000000000000000000000AsAsA000000000000000000000000000000000000000000000AsAsA00000000000000000000000000000000000000000000000000000000000AsA           A
A            AsA0000000000000000000000000000000000000000000000000000000000AsAsA000000000000000000000000000000000000000000000AsAsA00000000000000000000000000000000000000000000000000000000000AsA           A
A            AB6BBBBBBBBBBB00000000000000000000000000000000000BBBBBBBBBBBB6B6B6BBBBBBBBBBBB000000000000000000000BBBBBBBBBBBB6B6B6BBBBBBBBBBBB000000000000000000000000000000000000BBBBBBBBBBB6B3           A
A            AsA0000000000000000000000000000000000000000000000000000000000AsAsA000000000000000000000000000000000000000000000AsAsA00000000000000000000000000000000000000000000000000000000000AsA           A
A            AsA0000000000000000000000000000000000000000000000000000000000AsAsA000000000000000000000000000000000000000000000AsAsA00000000000000000000000000000000000000000000000000000000000AsA           A
A            AsA0000000000000000000000000000000000000000000000000000000000AsAsA000000000000000000000000000000000000000000000AsAsA00000000000000000000000000000000000000000000000000000000000AsA           A
A            3B6BBBBBBBBBBB00000000000000000000000000000000000BBBBBBBBBBBB6B6B6BBBBBBBBBBBB000000000000000000000BBBBBBBBBBBB6B6B6BBBBBBBBBBBB000000000000000000000000000000000000BBBBBBBBBBB6B3           A
A            AsA0000000000000000000000000000000000000000000000000000000000AsAsA000000000000000000000000000000000000000000000AsAsA00000000000000000000000000000000000000000000000000000000000AsA           A
A            AsA0000000000000000000000000000000000000000000000000000000000AsAsA000000000000000000000000000000000000000000000AsAsA00000000000000000000000000000000000000000000000000000000000AsA           A
A            AsA0000000000000000000000000000000000000000000000000000000000AsAsA000000000000000000000000000000000000000000000AsAsA00000000000000000000000000000000000000000000000000000000000AsA           A
A            AB6BBBBBBBBBBB00000000000000000000000000000000000BBBBBBBBBBBBRBRBRBBBBBBBBBBBB000000000000000000000BBBBBBBBBBBBRBRBRBBBBBBBBBBBB000000000000000000000000000000000000BBBBBBBBBBB6B3           A
A            AsA0000000000000000000000000000000000000000000000000000000000000000000000000000000000000000000000000000000000000000000000000000000000000000000000000000000000000000000000000000AsA           A
A            AsA0000000000000000000000000000000000000000000000000000000000000000000000000000000000000000000000000000000000000000000000000000000000000000000000000000000000000000000000000000AsA           A
A            AsA0000000000000000000000000000000000000000000000000000000000000000000000000000000000000000000000000000000000000000000000000000000000000000000000000000000000000000000000000000AsA           A
A            ABRBBBBBBBBBBB000000000000000000000000000000000000000000000000000000000000000000000000000000000000000000000000000000000000000000000000000000000000000000000000000000BBBBBBBBBBBRB3           A
A            KBBBBBBBBBBBBBBBBBBBBBBBBBBBBBBBBBBBBBBBBBBBBBBBBBBBBBBBBBBBBBBBBBBBBBBBBBBBBBBBBBBBBBBBBBBBBBBBBBBBBBBBBBBBBBBBBBBBBBBBBBBBBBBBBBBBBBBBBBBBBBBBBBBBBBBBBBBBBBBBBBBBBBBBBBBBBBBBBL           A
A          x                                                                                                                                                                                   x          A
A        x                                                                                                                                                                                       x        A
A      x                                                                                                                                                                                           x      A
A    x                                                                                                                                                                                               x    A
A  x                                                                                                                                                                                                   x  A
Ax                                                                                                                                                                                                       xA
KBBBBBBBBBBBBBBBBBBBBBBBBBBBBBBBBBBBBBBBBBBBBBBBBBBBBBBBBBBBBBBBBBBBBBBBBBBBBBBBBBBBBBBBBBBBBBBBBBBBBBBBBBBBBBBBBBBBBBBBBBBBBBBBBBBBBBBBBBBBBBBBBBBBBBBBBBBBBBBBBBBBBBBBBBBBBBBBBBBBBBBBBBBBBBBBBBBBBBBBBBL
